10 10
0 0
..........
.WW.WWWWW.
.W......W.
.W.WWWW.W.
.W.WC.W...
...W....W.
.W.W.WW.W.
.W......W.
.WWWWW.WW.
..........